xxxxxxxxxxxxxxxxxxxxxxxxxxxxxxxx
x  E                           x
x      D                       x
x  xxxxx                       x
x                              x
x                              x
x                              x
x xxx             xxxxxxxx     x
x      x                       x
x   xxxx                       x
x                              x
xx                             x
x xxxx                         x
x    xxxx                      x
x       xxxxxxxxxxxxxxxx       x
x                              x
x                              x
xxxxxxxxxxxxxxxxxxxxxxxxxxxxxxxx