xxxxxxxxxxxxxxxxxxxxxxxxxxxxxxxx
x                              x
x                              x
x                              x
x                              x
x  E                           x
x                              x
x                              x
x                              x
x                              x
x                              x
x                              x
x xxxx                         x
x    xxxx                      x
x       xxxxxxxxxxxxxxxx       x
x                              x
x                           E  x
xxxxxxxxxxxxxxxxxxxxxxxxxxxxxxxx